level = [
    "00000000063700000",
    "00000000040500000",
    "00000000040500000",
    "00000000040500000",
    "00000000050500000",
    "00000063280500000",
    "00000040000500000",
    "00000040062800000",
    "00000040037000000",
    "00000040005000000",
    "00000093705000000",
    "00000000505000000",
    "00000000504000000",
    "00000062809370000",
    "00000040000050000",
    "0000004000-050000",
    "00000040005050000",
    "00000050005050000",
    "0006328-637050000",
    "00040000405050000",
    "00040630928050000",
    "00050470000050000",
    "6328092---658--37",
    "40000000002800005",
    "40000633-00000005",
    "400004000633-0005",
    "40000500040000005",
    "92--2800040000005",
    "00000000040000005",
    "00000000092----28",
]
