level = [
        "6336333336333336333336333336333336333336333336333336333336333337",
        "p00p00000p00000p00000p00000p00000p00000p00000p00000p00000p00000p",
        "p00p00000p00000p00000p00000p00000p00000p00000p00000p00000p00000p",
        "p00p00u00p00u00p00u00p00u00p00u00p00u00p00u00p00u00p00u00p00u00p",
        "p00p00p00p00p00p00p00p00p00p00p00p00p00p00p00p00p00p00p00p00p00p",
        "p00p00p00p00p00p00p00p00p00p00p00p00p00p00p00p00p00p00p00p00p00p",
        "p00p00p00p00p00p00p00p00p00p00p00p00p00p00p00p00p00p00p00p00p00p",
        "p00p00p00p00p00p00p00p00p00p00p00p00p00p00p00p00p00p00p00p00p00p",
        "p00p00p00p00p00p00p00p00p00p00p00p00p00p00p00p00p00p00p00p00p00p",
        "p00p00p00p00p00p00p00p00p00p00p00p00p00p00p00p00p00p00p00p00p00p",
        "p00p00p00p00p00p00p00p00p00p00p00p00p00p00p00p00p00p00p00p00p00p",
        "p00p00p00p00p00p00p00p00p00p00p00p00p00p00p00p00p00p00p00p00p00p",
        "p00p00p00p00p00p00p00p00p00p00p00p00p00p00p00p00p00p00p00p00p00p",
        "p00p00p00p00p00p00p00p00p00p00p00p00p00p00p00p00p00p00p00p00p00p",
        "p00p00p00p00p00p00p00p00p00p00p00p00p00p00p00p00p00p00p00p00p00p",
        "p00p00p00p00p00p00p00p00p00p00p00p00p00p00p00p00p00p00p00p00p00p",
        "p00p00p00p00p00p00p00p00p00p00p00p00p00p00p00p00p00p00p00p00p00p",
        "p00p00p00p00p00p00p00p00p00p00p00p00p00p00p00p00p00p00p00p00p00p",
        "p00p00p00p00p00p00p00p00p00p00p00p00p00p00p00p00p00p00p00p00p00p",
        "p00p00p00p00p00p00p00p00p00p00p00p00p00p00p00p00p00p00p00p00p00p",
        "p00p00p00p00p00p00p00p00p00p00p00p00p00p00p00p00p00p00p00p00p00p",
        "p00p00p00p00p00p00p00p00p00p00p00p00p00p00p00p00p00p00p00p00p00p",
        "p00p00p00p00p00p00p00p00p00p00p00p00p00p00p00p00p00p00p00p00p00p",
        "p00p00p00p00p00p00p00p00p00p00p00p00p00p00p00p00p00p00p00p00p00p",
        "p00p00p00p00p00p00p00p00p00p00p00p00p00p00p00p00p00p00p00p00p00p",
        "p00-00p00-00p00-00p00-00p00-00p00-00p00-00p00-00p00-00p00-00-00p",
        "p00000p00000p00000p00000p00000p00000p00000p00000p00000p00000000p",
        "p00000p00000p00000p00000p00000p00000p00000p00000p00000p00000000p",
        "92--------------------------------------------------------------",
    ]