level = [
        "00000000063700000",
        "00000000040500000",
        "00000000040500000",
        "00000000040500000",
        "00000000040500000",
        "000000633r0500000",
        "00000040000500000",
        "000000400w2800000",
        "000000400e7000000",
        "00000040005000000",
        "00000092q05000000",
        "00000000405000000",
        "00000000405000000",
        "00000063r0e370000",
        "00000040000050000",
        "0000004000u050000",
        "0000004000p050000",
        "0000004000p050000",
        "000633txy2s050000",
        "00040000504050000",
        "00040wq0e3r050000",
        "00040540000050000",
        "633r0etxxxyca3337",
        "4000000000er00005",
        "40000w22q00000005",
        "400005009cxxz0005",
        "40000500040000005",
        "92--2800040000005",
        "00000000040000005",
        "00000000092----28",
    ]